111111111111111111111111111111111111111111111111111111111111
100100000000000000000000010000000010000010000000000000001001
10010000000000CCCCC0000001000000001000001000000CCCCC00001001
100100111111111111111110010011110010010010001111001111001001
100100100000000000000010010010010010010010001001001001001001
1001001C0C0C0C000MM0001001001001001001001MMM1001001001001001
100100100111111111110010010010010010010010001001001001001001
100100100100000000010010010010010010010011001001001001001001
100100100100111111110010010010010010010010001001001001001001
100100100100100000100010010010010010010M10001001001001001001
10010010010000010000001001C010C10010010010011001001001001001
10010010011111111111111001C010C1M010010010001CC1001001001001
1001001000000CCCCCC0000001C010C10010010010001CC1001001001001
1001001000000000000P000001C010C10010010011001CC1001001001001
10010010CCCCCCCCCCCC000001C010C10010010011001CC1001001001001
10010011111111111111111111C010C1001001M010001CC1001001001001
10010000000000000CCCCCCC01C010C1C010010010C01CC1001001001001
10010CCCCCCCCCCCCC00000001C010C1C010010010011001111001111001
10011111111111111111111101C010C1C010010010CCCCC0000000000001
10010001000100010001000101C010C1C010010010000000000000000001
10010100010001000100010001C010C1C010010010011111111111111001
10010111111111111111111111C010C1C010010010010000000000001001
1000000010000000CCCCCCCCCCC0M0C1C010C100100100000000000010E1
1000000010000000CCCCCCCCCC0000010010C10010010011111111001001
100111101001111111110011111110010010C10010010010000001001001
100100001001000000010010000000010010C1001001001CCCCCC1001001
10010111100100000001001000CCCC010010C10010010010001001001001
100100001001001111110011111111110010C1001MM10010001001001001
10011110100100100001001CCCCCC0000010C10010010011111001001001
100100001001001011010010000C00000010C1001001CCCCCCCCC1001001
100100001001001001010011111111110010C1001001CCCCCCCCC1001001
100101001001001111010010000CCC000010C10010011111111111001001
100001000001000000010010000CCC000010010010000000000000001001
100001000001000000010010011111111110010010000000000000001001
100101101111111000010010000010000010010011111111111111111001
100101101000000000010010CCCCCCCC001001CCCCCCCCCCCC0000000001
1001011010CCCCCCCCC10010010000000010010000000000000000000001
100101001111111000011111111111100011111111110000000000000001
100101001000000000000CCCCCCCCCCCC000000000000000000000000001
10010100100000000000000000000000000CCCCCCCCCCCC0000000000001
111111111111111111111111111111111111111111111111111111111111