111111111111111111111111111111
1P0000000000000000000000000001
100000000000000000000000000M01
100000000000000000000000000001
100000000000000000000000000001
1000000000C00000000000000M0001
100000000000000000000000000001
100000000000000000000000000001
100000000000000000000000000001
100000000000000000000000000001
100000000000000C00000000000001
100000000000000000000000000001
100000000000000000000000000001
100000000000000000000000000001
100000000000000000000000000001
1000000000000000000000000M0001
100000000000000000C00000000001
100000000000000000000000000001
100000000000000000000000000001
1000000000C000000000000000M001
100000000000000000000000000001
100000000000000000000000000001
1000000000000000E000000000M001
100000000000000000000000000001
111111111111111111111111111111