1111111111111111111111111111111111111111
1P00000000000000000000000000000000000001
1000000000000000000000000000000000000M01
1000000000000000000000000000000000000001
1000000000000000000000000000000000000001
1000000000000000000C000000000M0000000001
100000000000000000000000000000000M000001
100000000000000000000000000000000000E001
1000000000000000000000000000000000000001
1000000000000000000000000000000000000001
10000000000000000000000000000000C0000001
1000000000000000000000000000000000000001
1000000000000000000000000000000000000001
1000000000000000000000000000000000000001
1000000000000000000000000000000000000001
10000000000000000000000000000000000M0001
1000000000000000000000000000000000000001
100000000000000C000000000000000000000001
1000000000000000000000000000000000000001
1000000000000000000000000000000000000001
1000000000000000000000000000000000000001
1000000000000000000000000000000000000001
1000000000000000000000000000000000000001
10000000000000000000000000000000000C0001
1000000000000000000000000000000000000001
1000000000000000000000000000000000000001
1000000000000000000000000000000000000001
100000000C000000000000000000000000000001
1000000000000000000000000000000000000001
1111111111111111111111111111111111111111