11111111111
1P0C0000001
100E0000001
1C0E0000001
11111111111