111111111
1P1C00001
111000001
1C1E00001
111111111