111111111
1P0C00001
100000001
1C0E00000
111111111