111111111
1P0X00001
10000W001
1C0E00001
111111111