111111111111
1P0C00000001
100000000001
1C0000000001
111111111111