1111111111111111
1P0C000000000001
1P00000000000001
1C0E000000000001
1000000000000001
1111111111111111