111111111111
100C00000001
100000000001
1C00000000E1
111111111111